###$###
###0###
##00###
###00##
###0###
#0000##
####00_
